You wake up in a small cabin. You are alone, and you can't remember how you got here. Your pockets are empty and you don't have your phone. Try to find a way out.

project5
An Interactive Fiction by Lidewij Fryling
Release 1 / Serial number 190501 / Inform 7 build 6M62 (I6/v6.33 lib 6/12N) SD

Cabin
This is a very small cabin, very dark with only a candle in the center of the room. The walls are a dark colored log, and it it obvious it is very old. There is a large rug that covers the foor, and all the windows are foggy from the rain. There is a door to the porch.

On the bigtable are a Candle and a journal.

You can also see a pen and a Book (in which is a Map) here.

>look at candle
The candle seems freshly lit. It will last for a while. You can use this to see

* * *

>pick up candle
Taken.

>go east
Bathroom
The bathroom is also dimly lit, with a dirty mirror on the right side of the door. There is one shower and one toliet, and there is a small pink rug in the center of the room.

* * *

>go east
Bathroom
The bathroom is also dimly lit, with a dirty mirror on the right side of the door. There is one shower and one toliet, and there is a small pink rug in the center of the room.

>go back
You can't see any such thing.

>go west
Cabin
This is a very small cabin, very dark with only a candle in the center of the room. There is a large rug that covers the foor, and all the windows are foggy from the rain. There is a door to the outside, but it is locked.

You can see a Candle, a Rug and a Book (in which is a Map) here.

>go south
Kitchen
The kitchen is very cluttered but well lit. There are pots and pans everywhere, and there is a table with newspapers in the center. To the east, there is a door. It is unlocked.

* * *

>go north
Porch
The porch is an enclosed area with two rocking chairs. The floor is wooden, and the screendoor is locked. The floorboards are a little wobbly, and you might be able to pry one up.

You can see a screendoor, a rocking chair and a floorboards here.

>open screendoor
It seems to be locked.

>go north
(first opening the screendoor)
It seems to be locked.

* * *

>go north
Porch
The porch is an enclosed area with two rocking chairs. The floor is wooden, and the screendoor is locked. The floorboards are a little wobbly, and you might be able to pry one up.

You can see a screendoor, a rocking chair and a floorboards here.

>sit in rocking chair
You get onto the rocking chair.

>get up
You get off the rocking chair.

Porch
The porch is an enclosed area with two rocking chairs. The floor is wooden, and the screendoor is locked.

You can see a rocking chair here.

* * *

>go south
Kitchen
The kitchen is very cluttered but well lit. There are pots and pans everywhere, and there is a table with newspapers in the center. To the east, there is a door. It is unlocked.

You can see a fridge here.

>go east
Darkness
It is pitch dark, and you can't see a thing.

>go west
Kitchen
The kitchen is very cluttered but well lit. There are pots and pans everywhere, and there is a table with newspapers in the center. To the east, there is a door. It is unlocked.

You can see a fridge here.

>n
Cabin
This is a very small cabin, very dark with only a candle in the center of the room. There is a large rug that covers the foor, and all the windows are foggy from the rain. There is a door to the porch.

You can see a Candle, a Rug and a Book (in which is a Map) here.

>take candle
Taken.

>go south
Kitchen
The kitchen is very cluttered but well lit. There are pots and pans everywhere, and there is a table with newspapers in the center. To the east, there is a door. It is unlocked.

You can see a fridge here.

>e
Closet
The closet is not well lit, and there are old clothes scattered on the floor. It is very tight and only fits one person. There is a box in the corner filled with different objects.

You can see a box (in which is a key) here.

>open box
It isn't something you can open.

>take key
Taken.

>go west
Kitchen
The kitchen is very cluttered but well lit. There are pots and pans everywhere, and there is a table with newspapers in the center. To the east, there is a door. It is unlocked.

You can see a fridge here.

>n
Cabin
This is a very small cabin, very dark with only a candle in the center of the room. There is a large rug that covers the foor, and all the windows are foggy from the rain. There is a door to the porch.

You can see a Rug and a Book (in which is a Map) here.

>n
Porch
The porch is an enclosed area with two rocking chairs. The floor is wooden, and the screendoor is locked. The floorboards are a little wobbly, and you might be able to pry one up.

You can see a screendoor, a rocking chair and a floorboards here.

>n
(first opening the screendoor)
It seems to be locked.

>open screendoor
It seems to be locked.

>use key
That's not a verb I recognise.

>unlock screendoor
What do you want to unlock the screendoor with?

>key
You unlock the screendoor.

>go north
(first opening the screendoor)

Forest
The forest is dark, but you've made it out of the cabin!

You can see a screendoor here.

* * *

>go straight
You can't see any such thing.